############################ 
#            ##            #
# #### ##### ## ##### #### # 
# #### ##### ## ##### #### # 
#                  G       #
# #### ## ######## ## #### # 
#      ##    ##    ##      # 
###### ##### ## ##### ###### 
     # ##          ## #
     # ## ###  ### ## #      
###### ## #      # ## ###### 
          #      #        G#
###### ## #      # ## ###### 
     # ## ######## ## #      
     # ##          ## #      
###### ## ######## ## ###### 
#  G         ##            #
# #### ##### ## ##### #### # 
#   ##                ##   #
### ## ## ######## ## ## ### 
#      ##    ##    ##      # 
# ########## ## ########## # 
#P                         #
############################