#####
#P  #  
# # #  
#  G# 
#####
