
##############
#P···········#
#·####·#####·#
#·####·#####·#
#············#
#·#######·##·#
#···········G#
##############
