#####
#P..#
#.#.#
#..G#
#####
