
##############
#P           #
# #### ##### #
# #### ##### #
#            #
# ####### ## #
#           G#
##############