#########
#P......#
#.##.##.#
#......G#
#########
