#########
#P      #
# ## ## #
#      G#
#########
