############################
######                ######
###### ##### ## ##### ######
###### ##### ## ##### ######
#                  GG    G #
# #### ## ######## ## #### #
#      ##    ##    ## G    #
###### ##### ## ##### ######
###### ##          ## ######
###### ## ###  ### ## ######
######        P       ######
############################
