############################
######················######
######·#####·##·#####·######
######·#####·##·#####·######
#··················G·······#
#·####·##·########·##·####·#
#0·····##····##····##······#
######·#####·##·#####·######
######·##··········##·######
######·##·###  ###·##·######
######········P·······######
############################
