############################
######...G........G...######
######.#####.##.#####.######
######.#####.##.#####.######
#..........................#
#.####.##.########.##.####.#
#......##....##....##......#
######.#####.##.#####.######
######.##..........##.######
######.##.###..###.##.######
######........P.......######
############################
